############
#          #
#   S      #
#          #
#          #
#          #
############
