############
#   S      #
#          #
#          #
#          #
############
